"filename", "language", "C++", "CMake", "Makefile", "comment", "blank", "total"
"/home/yht/Projects/MyTinyWebServer/test/CMakeLists.txt", "CMake", 0, 85, 0, 0, 26, 111
"/home/yht/Projects/MyTinyWebServer/test/acceptor_test.cpp", "C++", 24, 0, 0, 0, 5, 29
"/home/yht/Projects/MyTinyWebServer/test/any_class_test.cpp", "C++", 45, 0, 0, 0, 5, 50
"/home/yht/Projects/MyTinyWebServer/test/asynclogging_test.cpp", "C++", 28, 0, 0, 3, 10, 41
"/home/yht/Projects/MyTinyWebServer/test/buffer_unittest.cpp", "C++", 63, 0, 0, 73, 29, 165
"/home/yht/Projects/MyTinyWebServer/test/channel_epoller_test.cpp", "C++", 30, 0, 0, 3, 9, 42
"/home/yht/Projects/MyTinyWebServer/test/config_test.cpp", "C++", 6, 0, 0, 0, 2, 8
"/home/yht/Projects/MyTinyWebServer/test/eventloop2_test.cpp", "C++", 12, 0, 0, 1, 5, 18
"/home/yht/Projects/MyTinyWebServer/test/eventloop_test.cpp", "C++", 19, 0, 0, 0, 3, 22
"/home/yht/Projects/MyTinyWebServer/test/eventloop_thread_test.cpp", "C++", 24, 0, 0, 1, 6, 31
"/home/yht/Projects/MyTinyWebServer/test/http_parser_unittest.cpp", "C++", 163, 0, 0, 24, 33, 220
"/home/yht/Projects/MyTinyWebServer/test/http_parser_with_tcp_server_test.cpp", "C++", 49, 0, 0, 2, 12, 63
"/home/yht/Projects/MyTinyWebServer/test/http_server_unittest.cpp", "C++", 547, 0, 0, 35, 82, 664
"/home/yht/Projects/MyTinyWebServer/test/httpserver_demo_test.cpp", "C++", 6, 0, 0, 0, 1, 7
"/home/yht/Projects/MyTinyWebServer/test/inet_address_unittest.cpp", "C++", 78, 0, 0, 5, 29, 112
"/home/yht/Projects/MyTinyWebServer/test/logfile_test.cpp", "C++", 27, 0, 0, 0, 9, 36
"/home/yht/Projects/MyTinyWebServer/test/logger_test.cpp", "C++", 39, 0, 0, 0, 6, 45
"/home/yht/Projects/MyTinyWebServer/test/makefile", "Makefile", 0, 0, 24, 9, 12, 45
"/home/yht/Projects/MyTinyWebServer/test/pending_functor_in_loop_test.cpp", "C++", 32, 0, 0, 1, 10, 43
"/home/yht/Projects/MyTinyWebServer/test/tcpconn_send2_test.cpp", "C++", 47, 0, 0, 1, 9, 57
"/home/yht/Projects/MyTinyWebServer/test/tcpconn_send3_test.cpp", "C++", 51, 0, 0, 1, 9, 61
"/home/yht/Projects/MyTinyWebServer/test/tcpconn_send_test.cpp", "C++", 43, 0, 0, 1, 9, 53
"/home/yht/Projects/MyTinyWebServer/test/tcpserver_test.cpp", "C++", 41, 0, 0, 1, 8, 50
"/home/yht/Projects/MyTinyWebServer/test/thread_test.cpp", "C++", 17, 0, 0, 5, 5, 27
"/home/yht/Projects/MyTinyWebServer/test/timer_self_cancel_test.cpp", "C++", 28, 0, 0, 0, 5, 33
"/home/yht/Projects/MyTinyWebServer/test/timer_test.cpp", "C++", 34, 0, 0, 0, 7, 41
"/home/yht/Projects/MyTinyWebServer/test/timewheel_test.cpp", "C++", 92, 0, 0, 11, 18, 121
"Total", "-", 1545, 85, 24, 177, 364, 2195