"filename", "language", "C++", "CMake", "comment", "blank", "total"
"/home/yht/Projects/MyTinyWebServer/src/CMakeLists.txt", "CMake", 0, 52, 0, 8, 60
"/home/yht/Projects/MyTinyWebServer/src/acceptor/acceptor.cpp", "C++", 102, 0, 7, 14, 123
"/home/yht/Projects/MyTinyWebServer/src/acceptor/acceptor.h", "C++", 26, 0, 0, 6, 32
"/home/yht/Projects/MyTinyWebServer/src/base/any.h", "C++", 51, 0, 4, 17, 72
"/home/yht/Projects/MyTinyWebServer/src/base/config.cpp", "C++", 118, 0, 4, 12, 134
"/home/yht/Projects/MyTinyWebServer/src/base/config.h", "C++", 28, 0, 12, 6, 46
"/home/yht/Projects/MyTinyWebServer/src/base/count_down_latch.h", "C++", 32, 0, 0, 8, 40
"/home/yht/Projects/MyTinyWebServer/src/base/inet_address.cpp", "C++", 100, 0, 0, 20, 120
"/home/yht/Projects/MyTinyWebServer/src/base/inet_address.h", "C++", 31, 0, 0, 8, 39
"/home/yht/Projects/MyTinyWebServer/src/base/thread.cpp", "C++", 86, 0, 3, 21, 110
"/home/yht/Projects/MyTinyWebServer/src/base/thread.h", "C++", 44, 0, 4, 19, 67
"/home/yht/Projects/MyTinyWebServer/src/buffer/buffer.cpp", "C++", 131, 0, 7, 35, 173
"/home/yht/Projects/MyTinyWebServer/src/buffer/buffer.h", "C++", 38, 0, 26, 16, 80
"/home/yht/Projects/MyTinyWebServer/src/channel/channel.cpp", "C++", 138, 0, 1, 39, 178
"/home/yht/Projects/MyTinyWebServer/src/channel/channel.h", "C++", 58, 0, 4, 12, 74
"/home/yht/Projects/MyTinyWebServer/src/epoller/epoller.cpp", "C++", 133, 0, 2, 20, 155
"/home/yht/Projects/MyTinyWebServer/src/epoller/epoller.h", "C++", 30, 0, 0, 11, 41
"/home/yht/Projects/MyTinyWebServer/src/eventloop/eventloop.cpp", "C++", 161, 0, 2, 40, 203
"/home/yht/Projects/MyTinyWebServer/src/eventloop/eventloop.h", "C++", 59, 0, 3, 18, 80
"/home/yht/Projects/MyTinyWebServer/src/eventloop/eventloop_thread.cpp", "C++", 42, 0, 4, 9, 55
"/home/yht/Projects/MyTinyWebServer/src/eventloop/eventloop_thread.h", "C++", 23, 0, 0, 8, 31
"/home/yht/Projects/MyTinyWebServer/src/eventloop/eventloop_threadpool.cpp", "C++", 39, 0, 1, 9, 49
"/home/yht/Projects/MyTinyWebServer/src/eventloop/eventloop_threadpool.h", "C++", 26, 0, 1, 9, 36
"/home/yht/Projects/MyTinyWebServer/src/http/http_connection.cpp", "C++", 279, 0, 15, 37, 331
"/home/yht/Projects/MyTinyWebServer/src/http/http_connection.h", "C++", 49, 0, 12, 14, 75
"/home/yht/Projects/MyTinyWebServer/src/http/http_message.cpp", "C++", 234, 0, 7, 42, 283
"/home/yht/Projects/MyTinyWebServer/src/http/http_message.h", "C++", 109, 0, 1, 27, 137
"/home/yht/Projects/MyTinyWebServer/src/http/http_parser.cpp", "C++", 313, 0, 14, 54, 381
"/home/yht/Projects/MyTinyWebServer/src/http/http_parser.h", "C++", 83, 0, 0, 14, 97
"/home/yht/Projects/MyTinyWebServer/src/http/http_server.cpp", "C++", 94, 0, 8, 14, 116
"/home/yht/Projects/MyTinyWebServer/src/http/http_server.h", "C++", 28, 0, 2, 10, 40
"/home/yht/Projects/MyTinyWebServer/src/logger/async_logger.cpp", "C++", 118, 0, 7, 17, 142
"/home/yht/Projects/MyTinyWebServer/src/logger/async_logger.h", "C++", 35, 0, 1, 6, 42
"/home/yht/Projects/MyTinyWebServer/src/logger/log_file.cpp", "C++", 157, 0, 6, 27, 190
"/home/yht/Projects/MyTinyWebServer/src/logger/log_file.h", "C++", 49, 0, 2, 13, 64
"/home/yht/Projects/MyTinyWebServer/src/logger/log_stream.cpp", "C++", 144, 0, 3, 34, 181
"/home/yht/Projects/MyTinyWebServer/src/logger/log_stream.h", "C++", 69, 0, 3, 20, 92
"/home/yht/Projects/MyTinyWebServer/src/logger/logger.cpp", "C++", 96, 0, 7, 26, 129
"/home/yht/Projects/MyTinyWebServer/src/logger/logger.h", "C++", 90, 0, 7, 23, 120
"/home/yht/Projects/MyTinyWebServer/src/main.cpp", "C++", 6, 0, 0, 1, 7
"/home/yht/Projects/MyTinyWebServer/src/tcp/tcp_connection.cpp", "C++", 311, 0, 33, 38, 382
"/home/yht/Projects/MyTinyWebServer/src/tcp/tcp_connection.h", "C++", 73, 0, 11, 23, 107
"/home/yht/Projects/MyTinyWebServer/src/tcp/tcp_server.cpp", "C++", 72, 0, 11, 21, 104
"/home/yht/Projects/MyTinyWebServer/src/tcp/tcp_server.h", "C++", 51, 0, 19, 18, 88
"/home/yht/Projects/MyTinyWebServer/src/timer/timeing_wheel.cpp", "C++", 70, 0, 9, 16, 95
"/home/yht/Projects/MyTinyWebServer/src/timer/timer.cpp", "C++", 111, 0, 13, 19, 143
"/home/yht/Projects/MyTinyWebServer/src/timer/timer.h", "C++", 55, 0, 1, 15, 71
"/home/yht/Projects/MyTinyWebServer/src/timer/timestamp.h", "C++", 83, 0, 4, 19, 106
"/home/yht/Projects/MyTinyWebServer/src/timer/timing_wheel.h", "C++", 44, 0, 0, 8, 52
"Total", "-", 4319, 52, 281, 921, 5573